%%%%%%%%%%%%%%%%%%%%%%%%%%%%%%%%%%%%%
%                                  P%
% %%%%%%% %%%%%%%%%%%%%%%%%%%%%%%%% %
%       %                     % %   %
%%%%% %%%%%%%%%%% % %%%%% %%%%% % %%%
%   % % % %   % % % %   % %     %   %
% %%% % % % %%% %%%%% %%% %%%%% %%% %
%       %     %   %   %     % % % % %
%%% %%%%%%%%% %%%%%%% %%% %%% % % % %
%             %       % %   %     % %
% % %%%%% % %%% % % %%% % %%% %%% % %
% % %     % % % % %     %   % % % % %
% % % %%%%%%% % %%%%%%%%% %%% % %%% %
% % % %     %   %     %     %   %   %
%%%%%%% % %%%%% %%%%% %%% %%% %%%%% %
%     % % %     % %     % %   % % % %
% % % % % %%% %%% %%% %%% % % % % % %
% % % % %                 % % %     %
%%% %%%%%%% % % %%%%% %%% % %%% %%%%%
%       % % % %     %   %     % %   %
%%%%% % % %%%%%%%%% %%%%%%% %%% % %%%
%     %           % %     %   % %   %
% %%% %%%%% %%%%%%%%% %%%%%%%%% %%% %
% % % %      %        %             %
% % % %%%%% %%% % % % % %%%%%%%%%%%%%
% % %   %     % % % %       %   % % %
% % %%% %%% % % % %%%%%%%%% %%% % % %
% %   % %   % % %   % %   % % %     %
% %%% %%% %%%%%%% % % % %%%%% % %%%%%
%       %   %     % %           %   %
%%% % %%%%% %%%%% %%% %%% % %%% % %%%
% % % % % % % %     % %   % % % % % %
% % % % % % % % %%%%%%%%% % % % % % %
%   %   %                     %     %
% % %%% %%% %%% %%%%%%% %%% %%% %%% %
%.%   % %     %   %       %   % %   %
%%%%%%%%%%%%%%%%%%%%%%%%%%%%%%%%%%%%%
