%%%%%%%%%%%%%%%%%%%%%%%%%%%%%%%%%%%%%
%                                  P%
%            %                      %
%            %                      %
%            %                      %
%            %                      %
%            %                      %
%            %  %    %              %
%            %  %    %              %
%            %  %    %              %
%            %  %    %              %
%            %  %    %              %
%            %  %    %              %
%            %  %    %              %
%%%%%%%%%%%%%%  %%%%%%%%%%%%%%%%%%%%%
%            %                      %
% %          %                      %
% %          %                      %
% %          %                      %
% %          %                      %
% % %%%%%%%%%%                      %
%.%                                 %
%%%%%%%%%%%%%%%%%%%%%%%%%%%%%%%%%%%%%