%%%%%%%%%%%%%%%%%%%%%%%%%%%%%%%
% %         %%    %  %%%%    P%
% % %%%%%%% %%%%%% %%%%%%% %%%%
%            %   %            %
%%%%%   %%          % %   % %%%
%   %%%%%% %%%%%%% %%% %%%%%%%%
% % %%%%%% %%%%%%%     %%%%%%%%
% % %%%%%% %%%%%%% %%% %%%%%%%%
% % %%%%%% %%%%%%%%%%%%%%%%%%%%
% % %%%%%% %%%%%%% %%% %%%%%%%%
%.%                %   %      %
%%%%%%%%%%%%%%%%%%%%%%%%%%%%%%%