%%%%%%%%%%%%%%%%%%%%%%%%%%%%%%%
%     %                 %    P%
% %%% % %%% %%%%%%% %%% %     %
% %   % %      %      % %     %
%   %%% % %%%% % %%%%   %%%   %
%%% % % % %      %  % %   % %%%
%   % %%% % %%% %%% % %%% %   %
% %%%       %     %       %%% %
%   % %%%%% %%%%%%% % %%% %   %
%%% %   % %    %    % %   % %%%
%   %%% % %%%% % %%%% % %%%   %
%       %      %      %     % %
%     % %%% %%%%%%% %%% % %%% %
%.     %             %   %    %
%%%%%%%%%%%%%%%%%%%%%%%%%%%%%%%