%%%%%%%%%%%%%%%%%%%%
%               %  %
%%%%%%%%%%% % %    %
%        P       % %
%%%%%%%%%%%%%%%%%% %
%   %              %
%   %              % 
%   %              %
%   %              %
%                  %
%.                 %
%%%%%%%%%%%%%%%%%%%%