%%%%%%%%%%%%%%%%%%%%%%%%%%%%%%%%%%%%%
%       % % %           %         % %
% %%%%%%% % %%% % %%% %%% %%%%%%% % %
%       %       % %     %     % %   %
%%%%% %%%%% %%% % % % %%% %%%%% % %%%
%   % % % %   % % % %   % %     %   %
% %%% % % % %%% %%%%% %%% %%%%% %%% %
%       %     %   %   %     % % % % %
%%% %%%%%%%%% %%%%%%% %%% %%% % % % %
%             %       % %   %     % %
% % %%%%% % %%% % % %%% % %%% %%% % %
% % %     % % % % %     %   % % % % %
% % % %%%%%%% % %%%%%%%%% %%% % %%% %
% % % %     %   %     %     %   %   %
%%% %%% % %%%%% %%%%% %%% %%% %%%%% %
%     % % %     % %     % %   % % % %
% % % % % %%% %%% %%% %%% % % % % % %
% % % % %                 % % %     %
%%% %%%%%%% % % %%%%% %%% % %%% %%%%%
%       % % % %     %   %     % %   %
%%%%% % % %%%%%%%%% %%%%%%% %%% % %%%
%     %           % %     %   % %   %
% %%% %%%%% %%%%%%%%% %%%%%%%%% %%% %
% % % %      %        %             %
% % % %%%%% %%% % % % % %%%%%%%%%%%%%
% % %   %     % % % %       %   % % %
% % %%% %%% % % % %%%%%%%%% %%% % % %
% %   % %   % % %   % %   % % %     %
% %%% %%% %%%%%%% % % % %%%%% % %%%%%
%       %   %     % %           %   %
%%% % %%%%% %%%%% %%% %%% % %%% % %%%
% %%% % % % % %     % %   % % % % % %
% % % % % % % % %%%%%%%%% % % % % % %
%   %   %   %                 %     %
% % % % %%% %%% %%%%%%% %%% %%% %%% %
%.%   %       %   %       %   % %  P%
%%%%%%%%%%%%%%%%%%%%%%%%%%%%%%%%%%%%%
