%%%%%%%%%%%%%%%%%%%%%%%%%%%%%%%%%%%%
%                                 P%
%%%%%%%%%%%%%% %%%%%%%%%%%%% %%%%%%%
% %%   %   % %       %       %     %
% %% % % % % %%%%%%% %%%%% %%% %%%%%
% %% % % % %             %%        %
% %% % % % % % %%%%  %%%    %%%%%% %
% %  % % %   %    %%%%%%%%%%%      % 
% %% % % %%%%%%%%%%%        %% %%%%%
% %% %   %%       %%%%%%%%% %%     %
%    %%%%%% %%%%%%%      %% %%%%%% %
% %%%%      %       %%%% %% %      %
%      %%%% % %%%%% %    %% %% %%%%%
%%%%%%%%              %%%%% %%     %
%        %%%%%% %%%%%%%%%%% %%  %% %
%%%%%%%%%%                  %%%%%% %
%.         %%%%%%%%%%%%%%%%        %
%%%%%%%%%%%%%%%%%%%%%%%%%%%%%%%%%%%%
