%%%%%%%%%%%%%%%%%%%%%%
%P%%          %      %
%    %%%%%%%% %%%%%% %
%%%%%%               %
%      %%%%%%%%% %%%%%
% %%%% %       % %   %
%    %   %%% %%%   % %
%%%% %%%%% %  %%%%%% %
%.         %%        %
%%%%%%%%%%%%%%%%%%%%%%
